
check-intro=Haz clic en cada uno de los siguientes enlaces para obtener una vista previa de la descripción que se subirá.
check-name=Comprueba
check-preview=Vista previa
choose-columns-advanced=Avanzado
choose-columns-exif=Fecha de precarga de Exif
choose-columns-fields-name=Nombre del campo
choose-columns-intro=En este paso puedes establecer la fuente de wikicódigo. Puedes elegir entre plantillas ya creadas o escribir wikicódigo por tu cuenta.
choose-columns-name=Elige columnas
choose-columns-radio-buttons=Si / Const / No
choose-columns-template=Plantilla
choose-columns-template-doc=Documentación de plantilla
choose-columns-template-intro=Selecciona los campos que consideres necesarios usando los siguientes botones. Si eliges "Sí", puedes completar los campos usando el campo de texto. Si seleccionas "Const", el valor del campo de texto se aplicará a todos los archivos sin posibilidad de cambiarlo en cada archivo.
choose-columns-value=Valor
choose-columns-wikicode=Escribe wikicódigo
choose-directory-include-subdirectories=Incluye archivos de subdirectorios
choose-directory-intro=Selecciona el directorio que contiene los archivos que se describirán en la hoja de cálculo. Haz clic en "Buscar" para seleccionar el directorio.
choose-directory-name=Elige directorio
choose-directory-no-files=No hay archivos adecuados para cargar.
choose-directory-window-name=Elige directorio
create-file-back-to-start=Continúa y carga
create-file-button=Crea archivo
create-file-error=¡Ocurrió un error durante la creación de la hoja de cálculo!
create-file-filename=Nombre de archivo (sin extensión)
create-file-name=Crea archivo
create-file-open=Abre archivo
create-file-success=Hoja de cálculo creada satisfactoriamente.
create-file-summary=Crearás una hoja de cálculo con %s archivos del directorio %s.
generic-back=Atrás
generic-browse=Buscar
generic-cancel=Cancelar
generic-next=Siguiente
generic-summary=Resumen
login-2fa=Haz clic aquí si habilitaste la autenticación de dos factores.
login-failed=Error de inicio de sesión
log-file=Archivo de registro
login-intro=Por favor inicia sesión con tu cuenta.
login-load=Iniciando sesión...
login-login-button=Iniciar sesión
login-login-field=Acceso
login-name=Acceso
login-password-field=Contraseña
start-bug-found=¿Encontraste un error?
start-bug-report=¡Avísanos!
start-generate-button=Generar hoja de cálculo
start-generate-description=Generar una hoja de cálculo seleccionando un directorio de tu disco duro.
start-new-version-available=¡Nueva versión disponible!
start-new-version-available-download=Descarga ahora.
start-validate-button=Validar y cargar
start-validate-description=Verifica si está todo correcto en tu hoja de cálculo y carga los archivos.
upload-button=Cargar
upload-continue=Continúa
upload-intro=Haz clic en "Cargar" para cargar los archivos. Puedes detener la carga en cualquier momento haciendo clic en el botón "Detener".
upload-log-canceled=Cancelación de subida solicitada. No se subirán más imágenes después de cargar una.
upload-log-done=Subida completada. %s archivos subidos, %s archivos omitidos.
upload-log-error=Error: %s.
upload-log-error-name-taken=Este nombre de archivo ya está usado
upload-log-success=¡Archivo subido!
upload-log-uploading=Cargando %s
upload-name=Cargar
upload-next-sheet=Sube la siguiente hoja de cálculo
upload-retry=Intentar de nuevo
upload-stop=Detener
validate-file-select=Selecciona archivo
validate-file-type=archisvos XLS (*.xls)
validate-intro=Elige hoja de cálculo con datos de archivos lista para cargar. Haz clic en "Buscar" para seleccionar el archivo.
validate-name=Carga

